1111111111
10000CE001
1000000P01
1110111111
10N0000001
1111111111