111111111111111111
10000000000E000101
1000000P0000001N11
111111111110000001
11110000000C000001
100000000000000C01
100000C00000000001
111111111111111111