1111111111111111111
1111111111111111111
10000C00000000000C1
10000000000E0000001
1000C00000001000001
1000010000001000001
100001C000001000001
1000C001P0001000001
1111111111111111111